111111111111
1P1111000001
1C0000000001
101111000001
1E0000000001
101111000001
101000000001
101111000001
1C0000000001
111111111111