1111111
111C0E1
1P1CC01
1111111