




1111111
1C00PE1
1P0CE01
1111111