1111111
1C000E1
1P0C001
1111111