1111111
1C0C0E1
1P0CC01
1111111