1111111111111111111111111111
111PCCCCCCCCCCCCCCCCCCCCC111
1011CCCCCCCCCCCCCCCCCCCC1101
10011CCCCCCCCCCCCCCCCCC11001
100011CCCCCCCCCCCCCCCC110001
1000011CCCCCCCCCCCCCC1100001
10000011CCCCCCCCCCCC11000001
1000000111111E11111110000001
10000011CCCCCCCCCCCC11000001
1000011CCCCCCCCCCCCCC1100001
100011CCCCCCCICCCCCCCC110001
10011CCCCCCCCCCCCCCCCCC11001
1011CCCCCCCCCCCCCCCCCCCC1101
111CCCCCCCCCCCCCCCCCCCCCC111
1111111111111111111111111111