11111111111111111111111
100P100000000000000E001
11111000000100000111111
100C00000001000C0000001
10000000000100000001111
100C00000001000C0001I11
11111111111111111111111