11111111111111111111111111111
1P111100000111110000011111001
1C000000000011110000000000001
10111100000111111111100001111
1E000000000100000000001000001
1011110CCCC111111111111011111
10100000000100000000000100001
10111100000111111111100100001
1C000000000111100000001000001
11111111111111111111111111111