11111111111111111111111111111
1P000000000000000000000000001
11111111111111111111111111101
10000000000000000000000000101
10111111111111111111111110101
10100000000000000000000010101
10101111111111111111111010101
10101E00000000000000000010101
10101111111111111111111110101
10100000000000000000000000101
1C111111111111111111111111101
1C000000000000000000000000001
11111111111111111111111111111
